Második pálya
0 19
1
20
R R R R R R R R R R R W W R R R W R R E
R W W W W R W W W W W W W R W R W R W W
R R R R R R R W W W R R R R W R R R W W
R W W W W W R R R R R W W W W W W W W R
R W R R R R R W W W W W W W W W W W W R
R W R W W W W W W W W W W W W R R R R R
R R R W W W W W W W W W W W W R W W W R
W W R R R R R R R R R R R R R R W W W R
W W W W W W W R W W W W W W W W W W W R
R W W W W W W R W W W W W W W W W W W R
R R R R R W W R W W R R R R R R R R R R
R R R W W W W R W W W W W W W W W W W R
R R R W W W W R W W W W W W W W W W W R
R R R W W R R R W W W W W W R R R R R R
R R R W R R W W W W W W W W R W R W W R
R W W W R R R R R R R R W W R W R R R R
R R R R R W W W W W W R W R W W R W W R
R W W R R R R R R R R R R R R R R W W R
R W W W W R W W W R W W R W W R R R R R
S R R R R R W W W R R R R W W R W W W W