Első pálya
0 9
1
10
R R R R R R R R R E
R W W W R R R W W R
W R R R R W W W W W
W W R W W R R R W W
W R R R R R R R R W
R W W W W R R W W W
W R R R R R W R R W
W R R W R R R R R W
R R R W R R W W R W
R R W W W W W W R W